40 20
========================================
=c___________m_________________________=
=______________________________________=
=____=___m_____________________________=
=____=________________________________==
=_____=________________________________=
=______=_______________________________=
=__e__m_=_________________p___________==
=________==____________________________=
=__________==__________________________=
=____________==________________________=
=_____m________===___=________________==
=___==____________====_________________=
=_____===_____________=====____________=
=________====_________________________==
=____________=======___________________=
=___________________=========__________=
=_____________________________________==
=_______m______________________________=
========================================